R 400 600
NO ./images/mossy.xpm
SO ./images/eagle.xpm
WE ./images/redbrick.xpm
EA ./images/wood.xpm

S ./images/barrel.xpm
F 220,100,0
C 225,30,0

        1111111111111111111111111
        0000000001100000000000001
        101100000111002200000W001
        1001000000000002000000001
111111111011000001110200020000001
100000000011000001110111111111111
11110111111111011100000010001
11110111111111011101010010001
11000000110101011100000010001
10002000000000001100000010001
10000000000000001101010010001
11000001110101011111011110000111
11110111 1110101 101111010001
11111111 1111111 111111111111