R 900 600

EA ./images/redbrick.xpm
SO ./images/greystone.xpm
WE ./images/wood.xpm
NO ./images/mossy.xpm

S ./images/pillar.xpm
F 220,100,0
C 200,0,0

        1111111111111111111111111
        1000000001100000000000001
        1011000001110220000000001
        1001000000000002000000001
111111111011000001110200020000001
100000000011000001110111111111111
11110111111111011100000010001
11110111111111011101010010001
11000000110101011100000010001
10002000000000001100000010001
100000000E0000001101010010001
11000001110101011111011110000111
11110111 1110101 101111010001
11111111 1111111 111111111111
