
EA ./images/wood.xpm
WE ./images/redbrick.xpm




SO ./images/greystone.xpm
NO ./images/mossy.xpm

R 900 600
S ./images/barrel.xpm
F 220,100,0

C 200,0,0

111111111111111111111111111111
10000000000000000000000000001
10000000000000000000000000001
10000000000000000000000000001
10000000000000000000000000001
10000000000000000000000000001
10000000000000000000000000001
10000000000000000000000000001
10000000000000000000000000001
10000000000000000022222000001
10000000000000000000000000001
100000000000000000000W0111001
1000000000000000000000011001
1111111111111111111111111111
